5 5 5 5 5 5 5 5 5 5 5 5 5 5 5 5 5 5 5 5 5 5 5 5 5 5 5 5 5 5
5 4 4 4 2 4 4 4 4 2 4 4 4 2 4 4 4 4 4 2 4 4 4 2 4 4 4 4 4 5
5 4 5 5 5 4 5 5 5 4 5 5 5 4 5 5 5 4 5 5 5 4 5 5 5 4 5 5 4 5
5 4 4 4 4 4 4 2 4 4 4 4 2 4 4 4 2 4 4 4 4 4 2 4 4 4 4 2 4 5
5 5 5 2 5 5 5 4 5 5 5 2 5 5 5 4 5 5 5 4 5 5 5 4 5 5 5 4 5 5
5 4 4 4 4 4 2 4 4 4 4 4 4 2 4 4 4 4 4 2 4 4 4 4 4 4 4 2 4 5
5 4 5 5 5 5 4 5 5 5 2 5 5 4 5 5 5 5 4 5 5 5 2 5 5 5 5 4 5 5
5 4 4 4 2 4 4 4 4 2 4 4 4 4 2 4 4 4 4 4 2 4 4 4 4 2 4 4 4 5
5 5 5 4 5 5 5 4 5 5 5 2 5 5 5 4 5 5 5 4 5 5 5 4 5 5 5 2 5 5
5 4 4 4 4 4 4 2 4 4 4 4 4 2 4 4 4 4 4 2 4 4 4 4 4 4 4 2 4 5
5 4 5 5 5 5 2 5 5 5 4 5 5 5 5 5 5 2 5 5 5 4 5 5 5 4 5 5 4 5
5 4 4 4 2 4 4 4 2 4 4 4 4 2 4 4 4 4 2 4 4 4 4 2 4 4 4 4 4 5
5 5 5 4 5 5 5 4 5 5 5 2 5 5 5 4 5 5 5 4 5 5 5 4 5 5 5 5 5 5
5 4 4 4 4 4 4 2 4 4 4 4 4 2 4 4 4 4 4 2 4 4 4 4 4 4 4 2 4 5
5 4 5 5 5 5 2 5 5 5 4 5 5 5 5 5 5 2 5 5 5 4 5 5 5 4 5 5 4 5
5 4 4 4 2 4 4 4 4 2 4 4 4 4 2 4 4 4 4 4 2 4 4 4 4 2 4 4 4 5
5 5 5 4 5 5 5 4 5 5 5 2 5 5 5 4 5 5 5 4 5 5 5 4 5 5 5 4 5 5
5 4 4 4 4 4 4 2 4 4 4 4 4 2 4 4 4 4 4 2 4 4 4 4 4 4 4 2 4 5
5 4 5 5 5 5 2 5 5 5 4 5 5 5 5 5 5 2 5 5 5 4 5 5 5 4 5 5 4 5
5 5 5 5 5 5 5 5 5 5 5 5 5 5 5 5 5 5 5 5 5 5 5 5 5 5 5 5 5 5